1111111111111111111111111111111111
1000000000000000000000000000000001
1010010100100000101001000000010101
1000000000000000000000000000000001
1010011010101010001001001000010101
100001P0000001C0000000001000000101
100000100000001000000001C0000001E1
1111111111111111111111111111111111
