1111111111111111111111111111111111
10000000000N000C00000C0000000000E1
100001010010000010100100000001N111
10100100101010100010010000000101C1
1P000N000C00C0000000000N0000000001
1111111111111111111111111111111111
