1111111111111111111111111111111111
1E0000000000000C00000C000000000001
1000010100100000101001000000010111
10100100101010100010010000000101C1
1P0000000C00C000000000010000000001
1111111111111111111111111111111111