1111111111111111111111111111111111
1E00000000000C00000000000000000001
1010010100100000101001000000010101
10000000000C0000000000000000000001
1010010010101010001001001000010101
100000P00000C0000000C000C0000000C1
10000000000C0000000000000000000001
1111111111111111111111111111111111