1111111111111111111111111111111111
1E00000000000C00000000000000000001
1010010100100000101001000000010101
10000000000C0000000000000000000001
1010010010101010001001000000010101
100000P00000C0000000C00000000000C1
10000000000C000000000000C000000001
1111111111111111111111111111111111